1111111111111111111111111
100000001000000000C000001
10P0000010000101000000001
1000000010001001000E00001
1000000010010C00001111111
1000000000001001000000001
100E000010000111000000001
100000001000000000C000001
1111111111111111111111111